B              B
B              B
B              B
B   E  E  E    B
B              B
B              B
B              B
B              B
B              B
B              B
B  W   W   W   B
B              B
B              B
B              B
B      P       B